00000100000,
00100100100,
00100100100,
00100100100,
00100100100,
20100000103,