111100000,
111200000,
111100000,
000000003,
000001111,
000001111,
000001111,