00000000,
00010000,
00312000,
01111100,
00010000,
00010000,
00000000,