000000000,
001010100,
000000000,
201010103,
000000000,
001010100,
000000000,