20100103,
00000100,
00100100,
00110110,
00100000,
00000100,
00100111,
10101100,
00000000,
00000000,