00111000001,
00000000000,
10000011100,
10000011100,
10000011100,
00000000000,
00111000001,
00111000003,
20111000001,