0012000,
0000000,
0110110,
0000000,
1001001,
0000000,
0031000,