200000000,
000110110,
000010100,
001010001,
000010103,
001010101,
000000100,